00000000001110000000000
00000000011011000000000
00000000010001000000000
00000000110001100000000
00000000110001100000000
00000000110001100000000
00000000110001100000000
00000000110001100000000
00000000110001100000000
00000000110001100000000
00000000110001100000000
00000000110001100000000
00000111110001111100000
00001110110001101110000
00001100110001100111110
00001100110001100111111
01111100010001000110011
11111100000000000110001
11001100000000000110001
11001100000000000000001
10001100000000000000001
10001100000000000000001
10001100000000000000001
11000000000000000000001
11000000000000000000011
11000000000000000000011
11000000000000000000011
01100000000000000000010
01100000000000000000110
00110000000000000000110
00110000000000000001100
00011000000000000011000
00001110000000000111000
00000111111111111100000
